139 40
###########################################################################################################################################
###########################################################################################################################################
#######...........................#########################################################################################################
#######...........................#########################################################################################################
#######...........................#########################################################################################################
#######...........................#########################################################################################################
#######...........................#########################################################################################################
#######...........................#########################################################################################################
#######...........................#########...............................................................#################################
#######...........................#########...............................................................#################################
#######...........................#########...............................................................#################################
#######...........................#########...............................................................#################################
#######...........................#########...............................................................#################################
#######...................................................................................................#################################
#####################.#####################...............................................................#################################
#####################.#####################...............................................................#################################
#####################.#####################...............................................................#################################
#####################.#####################...............................................................#################################
#####################.#####################################################################################################################
#####################.#####################################################################################################################
#####################.#####################################################################################################################
#####################.#####################################################################################################################
################............###############################################################################################################
################............####################.....................................................................................######
################.....................................................................................................................######
################............####################.....................................................................................######
################################################.....................................................................................######
###########################################################################################################################################
###########################################################################################################################################
###########################################################################################################################################
###########################################################################################################################################
###########################################################################################################################################
###########################################################################################################################################
###########################################################################################################################################
###########################################################################################################################################
###########################################################################################################################################
###########################################################################################################################################
###########################################################################################################################################
###########################################################################################################################################
###########################################################################################################################################