###########################################################################################################################################
###########################################################################################################################################
#######                           #########################################################################################################
#######                           #########################################################################################################
#######                           #########################################################################################################
#######                           #########################################################################################################
#######                           #########################################################################################################
#######                           #########################################################################################################
#######                           #########                                                               #################################
#######                           #########                                                               #################################
#######                           #########                                                               #################################
#######                           #########                                                               #################################
#######                           #########                                                               #################################
#######                                                                                                   #################################
##################### #####################                                                               #################################
##################### #####################                                                               #################################
##################### #####################                                                               #################################
##################### #####################                                                               #################################
##################### #####################################################################################################################
##################### #####################################################################################################################
##################### #####################################################################################################################
##################### #####################################################################################################################
################            ###############################################################################################################
################            ####################                                                                                     ######
################                                                                                                                     ######
################            ####################                                                                                     ######
################################################                                                                                     ######
###########################################################################################################################################
###########################################################################################################################################
###########################################################################################################################################
###########################################################################################################################################
###########################################################################################################################################
###########################################################################################################################################
###########################################################################################################################################
###########################################################################################################################################
###########################################################################################################################################
###########################################################################################################################################
###########################################################################################################################################
###########################################################################################################################################
###########################################################################################################################################